111111111111
111111111111
001100110011
000011001100
000000110000
