111111111111
111111111111
001100110011
011111001100
000000010000
